4 3 3 5 7
3 20 30 40
6 1 1 1 1 1 10
4 3 3 5 7
96 3997 8515 6053 2378 9690 9576 7977 2792 16 2494 351 5611 5645 1083 8572 5959 927 2903 1722 6914 6195 2267 4926 3370 8799 8495 4466 2391 5128 8009 1059 2088 6897 6982 9820 8869 9505 6035 1902 7113 343 5267 2301 2517 4084 5351 8508 1403 8328 8034 4374 7394 357 1668 2538 2430 9220 4212 7276 132 1984 8128 1319 9096 9411 3846 6972 5916 3169 8505 8254 3400 7033 837 8568 6296 4688 18 5173 5100 7323 8816 5832 2097 1081 670 7621 6883 7987 6768 5351 2299 9857 3067 7038 6016
19 4264 2925 3068 4957 3125 2640 7756 4636 752 4087 8340 4710 4798 795 3717 6410 2466 7229 1460
72 4034 9723 2924 5811 8119 9759 4989 5088 2056 3458 5103 6856 5224 5489 8743 8260 8082 2634 2151 3597 1606 1432 6692 6429 396 6233 1605 3642 6503 8972 8427 7161 1182 4974 2747 2868 1259 6771 3402 2842 1886 6337 5178 1525 723 9484 6953 5629 2534 3482 4572 6281 3028 3394 8818 2964 307 4689 9917 1414 9867 1262 1927 5648 8307 2222 5793 4246 2841 7153 2191 7727
76 8017 3920 1463 8826 6331 7020 2398 7735 2993 6938 5740 9072 7528 5742 3963 2768 3513 48 2064 1253 4673 2503 5478 7428 5870 7150 4781 2941 5415 782 2288 5200 7708 888 7364 9271 8567 1365 6947 9770 4049 1169 9763 4733 5577 8240 109 1517 9954 6387 3852 3054 1504 2827 3546 3647 6951 4532 438 9925 3062 8903 9877 5987 4114 4637 4209 6354 5344 6488 3732 2106 274 9073 8708 4481
3 4749 2860 3067
78 9489 5286 9145 4943 1766 6919 9101 6629 622 4941 1561 9700 4347 2294 1977 9423 4976 1723 9507 4080 4581 7955 3887 6660 3957 1308 7732 9943 6545 9209 3046 3611 4082 5990 4085 5566 4463 776 7918 8772 8736 8958 9378 4152 1075 5556 5757 3349 4165 7571 6050 4096 6757 5632 958 881 3801 9297 3545 7036 9440 6991 9584 590 7000 4974 3903 9070 9564 9147 2705 148 4838 781 3406 2820 3221 6040
3 20 30 40
81 5820 3159 629 7302 4706 9330 4211 5846 5250 9742 4711 9751 5875 1117 6149 4467 882 9807 9750 3345 5863 7696 1765 9032 6516 7597 2771 4050 2540 3153 2189 2942 3334 1946 4578 3018 1181 1504 1105 2488 7742 6154 246 7805 9226 5504 2406 1376 1471 3915 2380 3024 3541 4756 3043 6753 9213 3685 2657 1562 2521 1940 4658 5642 9629 7363 1570 5995 4297 338 9817 7169 1078 8841 6394 7085 4140 2861 4014 4153 3751
54 7116 1585 6235 2492 7702 8555 1773 9615 8221 7010 8297 2589 1378 1966 4964 3634 1132 7850 9477 3831 9933 1619 8691 8010 940 4157 2203 2466 3910 2940 8402 5515 7945 1583 525 5032 263 6702 1576 2485 6761 8120 3423 4720 99 1556 6597 9544 24 870 3155 1466 9832 4240