..........
..*.......
...*......
.***......
..........
..........
..........
..........
..........
..........